R 1920 1080

NO ./textures/wood.xpm
SO ./textures/bluestone.xpm
WE ./textures/bluestone.xpm
EA ./textures/wood.xpm
S ./textures/next.xpm

F 100,20,9
C 120,100,30

11111111111111111111111111
10000000000000000000000001
10000000S00001111110000001
10000000000000111100000001
11111111000000011000000001
1SSS0000000000000000000001
100000000S0000011111111111
10000N0000000001
1000000000000001
1000000001111111
1000S00001111111
100000000000S001
1000000000000001
1000000000000011
111111111000001
        1000001
		1000001
		1000001
		1000001
		10000S1
		1111111
