R 800 600

NO ./textures/wood.xpm
SO ./textures/bluestone.xpm
WE ./textures/bluestone.xpm
EA ./textures/wood.xpm
S ./textures/next.xpm

F 0, 120, 80
C 0, 125, 90

111111111111111111111111
100000000000000000000001
100000000000000000000001
100000222220000101010001
100000200020000000000001
100000200020000100010001
100000200020000000000001
100000220220000101010001
100000000000000000000001
100000000000000000001101
100000000000000000001001
100000000000000101001001
100000000000000000001001
100000000000000101001101
1000000000000000000000W1
111110111000000000000001
100000001000000000000001
100000201000000000000001
100100001000000000000001
110111111000000000000001
100000000000000000000001
100000000000000000000001
111111111111111111111111