R 600 400

NO ./textures/wood.xpm
SO ./textures/bluestone.xpm
WE ./textures/bluestone.xpm
EA ./textures/wood.xpm
S ./textures/next.xpm

F 0, 0, 0
C 255, 255, 255

111111111111111111111111
100000000000000000000001
100000000000W00000000001
100000000000000000000001
100000222220000101010001
100000200020000000000001
100000200020000100010001
100000200020000000000001
100000220220000101010001
100000000000000000000001
100000000000000000000101
100000000000000000001101
100000000000000000000101
100000000000000000001101
100000000000000000000101
100000000000000000000001
111111111000000000000001
110100001000000000000001
110000201000000000000001
110100001000000000000001
110111111000000000000001
100000000000000000000001
100000000000000000000001
111111111111111111111111