R 1920 1080

1111111111111111111
1000000000010000001
1000000000000000001
1000000000000000001
1111111100000220001
1000000000000000001
1000000000000000001
1000000111000000001111111111
1000000000000000000000000001
1000000000000000000000000001
1000000001111111111111111001
1000000000000000001000000001
100000N000000000001000000001
1000000000000000001000000001
1111111111110000000000000001
           11111111111111111
