R 600 400

NO ./textures/wood.xpm
SO ./textures/bluestone.xpm
WE ./textures/bluestone.xpm
EA ./textures/wood.xpm
S ./textures/next.xpm

F 60,60,60
C 205,205,205

11111111
10000001
10000001
10000001
100000W1
11111111