R 800 650

NO ./textures/1.xpm
SO ./textures/1.xpm
WE ./textures/1.xpm
EA ./textures/1.xpm
S ./textures/kda.xpm

C 0, 0, 0
F 0, 0, 0

111111111111111111111111
100000000000000000000001
100000000000000100000001
100000000001111010000001
100000000010000001000001
100000020100000000100001
10000E000002000000000111
100000020111111110000001
100000000000000000000001
100000000000000000001101
100000000000000000001001
100000000000000101001001
100000000000000000001001
100000000000000101001101
100000000000000000000001
111110111000000000000001
100000001000000000000001
100000201000000000000001
100100001000000000000001
110111111000000000000001
100000000000000000000001
100000000000000000000001
111111111111011111111111
 101001    1011
110101111111011
100000010001001
111110110101101
101000000111001
101111100001011
100000101111001
111010100000001
100010101111111
101110101000101
101000100011101
101110000100001
100100010001111
100001011101001
101111010101101
100001000100001
111111111111111