R 600 400

NO ./textures/wood.xpm
SO ./textures/bluestone.xpm
WE ./textures/bluestone.xpm
EA ./textures/wood.xpm
S ./textures/next.xpm

F 1, 1, 1
C 0, 150, 255

        1111111111111111111111111
        1000000000110000000000001
        1011000001110000002000001
        1001000000000000000000001
111111111011000001110000000000001
100000000011000001110111111111111
11110111111111011100000010001
11110111111111011101010010N01
11000000110101011111111110001
100020000000000011      10001
10000000000000001111111110001
11000001110101011111011110001
11110111 1100101 101111010001
11111111  111111 111111111111